//MAP CONVERTED BY dmm2tgm.py THIS HEADER COMMENT PREVENTS RECONVERSION, DO NOT REMOVE
"a" = (
/obj/machinery/button/door{
	pixel_x = -10;
	pixel_y = -21;
	id = "Second_door";
	dir = 1;
	name = "Second doors"
	},
/obj/machinery/button/shieldwallgen{
	pixel_y = -20;
	pixel_x = 12;
	id = "Torpedo_holofield2";
	dir = 1
	},
/obj/structure/chair/comfy/shuttle{
	dir = 4
	},
/turf/open/floor/mineral/titanium/blue,
/area/ship/bridge)
"b" = (
/obj/structure/cable{
	icon_state = "1-8"
	},
/obj/structure/cable{
	icon_state = "1-4"
	},
/obj/structure/cable{
	icon_state = "1-2"
	},
/turf/open/floor/mineral/titanium/blue,
/area/ship/bridge)
"e" = (
/obj/structure/cable{
	icon_state = "4-8"
	},
/obj/structure/cable/yellow{
	icon_state = "1-2"
	},
/turf/open/floor/mineral/titanium/blue,
/area/ship/bridge)
"g" = (
/obj/structure/cable{
	icon_state = "2-4"
	},
/obj/structure/cable/yellow{
	icon_state = "1-8"
	},
/turf/open/floor/mineral/titanium,
/area/ship/bridge)
"h" = (
/obj/item/radio/intercom/wideband/directional,
/obj/machinery/porta_turret/ship/faction/nanotrasen{
	pixel_x = 1;
	pixel_y = -4
	},
/turf/closed/wall/mineral/titanium,
/area/ship/bridge)
"j" = (
/obj/structure/window/plasma/reinforced/fulltile,
/obj/structure/grille,
/obj/machinery/door/poddoor/shutters/preopen{
	id = "Torpeda_windows";
	dir = 4
	},
/turf/open/floor/plasteel/dark,
/area/ship/bridge)
"l" = (
/obj/machinery/power/terminal{
	dir = 8
	},
/obj/structure/cable{
	icon_state = "2-6"
	},
/obj/structure/cable/yellow{
	icon_state = "0-4"
	},
/turf/open/floor/mineral/titanium,
/area/ship/bridge)
"n" = (
/obj/structure/cable{
	icon_state = "0-1"
	},
/obj/machinery/power/shieldwallgen/atmos/roundstart{
	dir = 4;
	id = "Torpedo_holofield2"
	},
/obj/machinery/door/poddoor/preopen{
	id = "Second_door"
	},
/turf/open/floor/plasteel/dark,
/area/ship/bridge)
"p" = (
/obj/structure/chair/comfy/shuttle{
	dir = 4;
	name = "Seat of Kovrik"
	},
/obj/structure/cable{
	icon_state = "1-8"
	},
/obj/machinery/light/floor,
/obj/structure/chair/comfy/shuttle{
	dir = 4
	},
/turf/open/floor/mineral/titanium,
/area/ship/bridge)
"q" = (
/obj/machinery/computer/secure_data{
	dir = 8
	},
/turf/open/floor/mineral/titanium/blue,
/area/ship/bridge)
"r" = (
/obj/structure/cable{
	icon_state = "0-6"
	},
/obj/machinery/power/smes/engineering,
/turf/open/floor/mineral/titanium,
/area/ship/bridge)
"u" = (
/obj/machinery/power/shieldwallgen/atmos/roundstart{
	dir = 8;
	id = "Torpedo_holofield2"
	},
/obj/structure/cable{
	icon_state = "0-1"
	},
/obj/machinery/door/poddoor/preopen{
	id = "Second_door"
	},
/turf/open/floor/plasteel/dark,
/area/ship/bridge)
"w" = (
/obj/structure/cable{
	icon_state = "0-2"
	},
/obj/machinery/power/shieldwallgen/atmos/roundstart{
	dir = 8;
	id = "Torpedo_holofield"
	},
/obj/machinery/door/poddoor/preopen{
	id = "First_door"
	},
/obj/docking_port/mobile{
	dir = 4;
	preferred_direction = 4;
	port_direction = 2
	},
/obj/structure/cable{
	icon_state = "2-8"
	},
/turf/open/floor/plasteel/dark,
/area/ship/bridge)
"x" = (
/obj/structure/cable{
	icon_state = "0-8"
	},
/obj/machinery/power/apc/auto_name/directional/north{
	pixel_x = 5;
	pixel_y = 26
	},
/obj/machinery/computer/crew{
	dir = 8
	},
/turf/open/floor/mineral/titanium/blue,
/area/ship/bridge)
"z" = (
/obj/structure/cable{
	icon_state = "2-8"
	},
/turf/open/floor/mineral/titanium/blue,
/area/ship/bridge)
"A" = (
/obj/structure/sign/nanotrasen,
/turf/closed/wall/mineral/titanium,
/area/ship/bridge)
"B" = (
/obj/structure/cable{
	icon_state = "4-8"
	},
/obj/structure/cable{
	icon_state = "1-8"
	},
/turf/open/floor/mineral/titanium/blue,
/area/ship/bridge)
"E" = (
/obj/structure/cable{
	icon_state = "0-4"
	},
/obj/machinery/power/shuttle/engine/electric{
	dir = 4
	},
/turf/open/floor/plating,
/area/ship/bridge)
"G" = (
/obj/structure/cable{
	d2 = 2;
	icon_state = "0-2";
	pixel_y = 1
	},
/obj/structure/cable{
	icon_state = "2-4"
	},
/obj/structure/cable{
	icon_state = "2-8"
	},
/obj/machinery/button/door{
	id = "First_door";
	name = "First doors";
	pixel_x = -10;
	pixel_y = 24
	},
/obj/machinery/button/door{
	id = "Torpeda_windows";
	name = "Window shutters";
	pixel_x = 2;
	pixel_y = 24
	},
/obj/machinery/light_switch{
	pixel_x = 23;
	pixel_y = 23
	},
/obj/machinery/button/shieldwallgen{
	pixel_x = 11;
	pixel_y = 21;
	id = "Torpedo_holofield"
	},
/obj/structure/chair/comfy/shuttle{
	dir = 4
	},
/turf/open/floor/mineral/titanium/blue,
/area/ship/bridge)
"I" = (
/obj/structure/cable{
	icon_state = "4-8"
	},
/obj/machinery/holopad/emergency/command,
/turf/open/floor/mineral/titanium,
/area/ship/bridge)
"J" = (
/obj/machinery/power/terminal{
	dir = 8
	},
/obj/structure/cable{
	icon_state = "0-4"
	},
/obj/structure/chair/comfy/shuttle{
	dir = 2;
	name = "tactical chair"
	},
/obj/machinery/airalarm/directional/north,
/turf/open/floor/mineral/titanium/blue,
/area/ship/bridge)
"K" = (
/obj/machinery/door/poddoor/preopen{
	id = "First_door"
	},
/obj/machinery/power/shieldwallgen/atmos/roundstart{
	dir = 4;
	id = "Torpedo_holofield"
	},
/obj/structure/cable{
	icon_state = "0-4"
	},
/obj/structure/cable/yellow{
	icon_state = "1-2"
	},
/turf/open/floor/plasteel/dark,
/area/ship/bridge)
"L" = (
/obj/structure/cable{
	icon_state = "0-4"
	},
/obj/machinery/button/door{
	pixel_x = -7;
	pixel_y = -21;
	id = "Torpedo_thr";
	dir = 1;
	name = "Thrusters doors"
	},
/obj/structure/chair/comfy/shuttle{
	dir = 1;
	name = "tactical chair"
	},
/obj/machinery/power/terminal{
	dir = 8
	},
/obj/structure/cable{
	icon_state = "1-9"
	},
/obj/machinery/turretid{
	pixel_x = 2;
	pixel_y = -27
	},
/turf/open/floor/mineral/titanium/blue,
/area/ship/bridge)
"N" = (
/obj/structure/window/plasma/reinforced/spawner/west,
/obj/structure/cable{
	icon_state = "0-8"
	},
/obj/machinery/power/smes/shuttle/precharged,
/obj/machinery/door/poddoor/shutters{
	id = "Torpedo_thr";
	dir = 4
	},
/turf/open/floor/mineral/titanium/blue,
/area/ship/bridge)
"Q" = (
/obj/machinery/computer/helm{
	dir = 8
	},
/turf/open/floor/mineral/titanium,
/area/ship/bridge)
"R" = (
/turf/closed/wall/mineral/titanium,
/area/ship/bridge)
"U" = (
/obj/machinery/porta_turret/ship/faction/nanotrasen,
/turf/closed/wall/mineral/titanium,
/area/ship/bridge)
"V" = (
/obj/machinery/porta_turret/ship/faction/nanotrasen{
	pixel_x = 0;
	pixel_y = 8
	},
/turf/closed/wall/mineral/titanium,
/area/ship/bridge)
"W" = (
/obj/structure/cable{
	icon_state = "2-10"
	},
/obj/structure/cable/yellow{
	icon_state = "4-8"
	},
/turf/open/floor/mineral/titanium,
/area/ship/bridge)
"X" = (
/obj/structure/window/reinforced/spawner/east,
/obj/structure/window/reinforced/spawner/west,
/obj/structure/chair/greyscale,
/obj/machinery/door/window/brigdoor,
/obj/structure/cable{
	icon_state = "4-8"
	},
/obj/machinery/light/dim/directional/north{
	pixel_x = 0;
	pixel_y = 27
	},
/turf/open/floor/circuit,
/area/ship/bridge)
"Y" = (
/obj/structure/grille,
/obj/machinery/door/poddoor/shutters/preopen{
	id = "Torpeda_windows";
	dir = 4
	},
/obj/structure/window/plasma/reinforced/fulltile,
/turf/open/floor/plasteel/dark,
/area/ship/bridge)
"Z" = (
/obj/structure/cable{
	icon_state = "4-8"
	},
/obj/machinery/light/dim/directional/south,
/obj/structure/cable{
	icon_state = "1-4"
	},
/obj/structure/closet/secure_closet/security{
	anchored = 1
	},
/obj/item/storage/box/handcuffs,
/turf/open/floor/circuit,
/area/ship/bridge)

(1,1,1) = {"
R
E
R
E
R
"}
(2,1,1) = {"
U
N
r
N
U
"}
(3,1,1) = {"
R
J
l
L
R
"}
(4,1,1) = {"
A
X
W
Z
A
"}
(5,1,1) = {"
K
e
g
b
n
"}
(6,1,1) = {"
w
B
I
z
u
"}
(7,1,1) = {"
R
G
p
a
R
"}
(8,1,1) = {"
V
x
Q
q
h
"}
(9,1,1) = {"
R
Y
Y
j
R
"}
