//MAP CONVERTED BY dmm2tgm.py THIS HEADER COMMENT PREVENTS RECONVERSION, DO NOT REMOVE
"e" = (
/turf/open/space/basic,
/area/space)
"E" = (
/turf/open/space/basic,
/area/ship/bridge)

(1,1,1) = {"
E
e
e
e
e
e
e
"}
(2,1,1) = {"
e
e
e
e
e
e
e
"}
(3,1,1) = {"
e
e
e
e
e
e
e
"}
(4,1,1) = {"
e
e
e
e
e
e
e
"}
(5,1,1) = {"
e
e
e
e
e
e
e
"}
(6,1,1) = {"
e
e
e
e
e
e
e
"}
(7,1,1) = {"
e
e
e
e
e
e
e
"}
(8,1,1) = {"
e
e
e
e
e
e
e
"}
(9,1,1) = {"
e
e
e
e
e
e
e
"}
