//MAP CONVERTED BY dmm2tgm.py THIS HEADER COMMENT PREVENTS RECONVERSION, DO NOT REMOVE
"a" = (
/obj/machinery/power/shuttle/engine/electric{
	dir = 4
	},
/obj/structure/cable{
	icon_state = "0-4"
	},
/turf/open/floor/plating/ship,
/area/ship/bridge)
"b" = (
/obj/machinery/power/smes/shuttle/precharged{
	dir = 4
	},
/obj/machinery/door/window/eastright{
	name = "Engine Access";
	dir = 2
	},
/obj/structure/window/plasma/reinforced/spawner/west,
/obj/structure/window/plasma/reinforced/spawner/west{
	dir = 1
	},
/obj/machinery/door/poddoor{
	id = "iron_maiden_eng";
	name = "Engine Blast Door"
	},
/obj/structure/cable{
	icon_state = "0-8"
	},
/turf/open/floor/plating,
/area/ship/bridge)
"c" = (
/obj/effect/turf_decal/corner/opaque/brown{
	dir = 4
	},
/obj/effect/turf_decal/corner/opaque/yellow,
/obj/machinery/computer/helm{
	dir = 8
	},
/turf/open/floor/plasteel/tech,
/area/ship/bridge)
"d" = (
/obj/effect/turf_decal/siding/brown{
	dir = 1
	},
/obj/item/flashlight/seclite,
/obj/item/clothing/head/beret/sec/inteq,
/obj/item/clothing/head/helmet/swat/inteq,
/obj/item/clothing/suit/armor/vest/inteq,
/obj/item/storage/belt/security/webbing/inteq/alt,
/obj/item/clothing/shoes/combat,
/obj/item/radio/headset/inteq,
/obj/item/clothing/gloves/combat,
/obj/item/storage/belt/security/webbing/inteq,
/obj/item/clothing/glasses/hud/security/sunglasses/inteq,
/obj/item/storage/backpack/messenger/inteq,
/obj/structure/closet/secure_closet/wall{
	icon_state = "generic_wall";
	name = "equipment locker";
	pixel_y = 28;
	dir = 1
	},
/obj/machinery/power/apc/auto_name/directional/east,
/obj/machinery/power/terminal{
	dir = 4
	},
/obj/structure/cable{
	icon_state = "0-2"
	},
/obj/item/clothing/suit/armor/vest/inteq,
/obj/item/storage/belt/security/webbing/inteq/alt,
/obj/item/clothing/head/beret/sec/inteq,
/obj/item/clothing/shoes/combat,
/obj/item/clothing/suit/space/inteq,
/obj/item/clothing/suit/space/inteq,
/obj/item/tank/internals/emergency_oxygen/double,
/obj/item/tank/internals/emergency_oxygen/double,
/turf/open/floor/plasteel/mono/dark,
/area/ship/bridge)
"e" = (
/obj/effect/turf_decal/trimline/opaque/solgovgold/warning{
	dir = 4
	},
/turf/open/floor/plasteel/tech/grid,
/area/ship/bridge)
"f" = (
/obj/structure/catwalk/over/plated_catwalk/dark,
/obj/machinery/atmospherics/pipe/simple/scrubbers/hidden/layer4{
	dir = 8
	},
/obj/machinery/atmospherics/pipe/simple/supply/hidden/layer2{
	dir = 8
	},
/obj/structure/cable{
	icon_state = "4-8"
	},
/obj/structure/cable{
	icon_state = "1-4"
	},
/turf/open/floor/plasteel/tech/grid,
/area/ship/bridge)
"g" = (
/obj/effect/turf_decal/trimline/opaque/solgovgold/arrow_ccw{
	dir = 1
	},
/obj/machinery/atmospherics/components/binary/pump/on/layer4{
	dir = 8
	},
/obj/machinery/atmospherics/pipe/manifold/supply/hidden/layer2,
/obj/structure/cable{
	icon_state = "1-2"
	},
/obj/structure/cable{
	icon_state = "1-4"
	},
/turf/open/floor/plasteel/mono/dark,
/area/ship/bridge)
"h" = (
/obj/structure/window/plasma/reinforced/spawner/west{
	dir = 2
	},
/obj/machinery/power/terminal,
/obj/structure/cable,
/obj/structure/table/optable,
/obj/structure/curtain/cloth,
/turf/open/floor/plasteel/mono/white,
/area/ship/bridge)
"i" = (
/obj/machinery/door/poddoor/shutters/preopen{
	dir = 4;
	id = "iron_maiden_bridge";
	name = "Blast Shutters"
	},
/obj/effect/spawner/structure/window/plasma/reinforced/plastitanium,
/turf/open/floor/plating,
/area/ship/bridge)
"j" = (
/obj/machinery/door/window/brigdoor/westleft{
	req_ship_access = 1
	},
/obj/machinery/holopad,
/obj/machinery/door/firedoor/border_only{
	dir = 8
	},
/obj/structure/closet/secure_closet/wall{
	icon_state = "generic_wall";
	name = "equipment locker";
	pixel_y = -28
	},
/obj/item/clothing/suit/armor/vest/security/warden/inteq,
/obj/item/clothing/head/warden/inteq,
/obj/item/melee/baton/loaded,
/obj/item/storage/box/ammo/a357,
/obj/item/clothing/mask/gas/sechailer,
/obj/item/tank/jetpack/oxygen,
/obj/item/clothing/suit/space/hardsuit/syndi/inteq,
/turf/open/floor/plasteel/mono/dark,
/area/ship/bridge)
"k" = (
/obj/machinery/door/airlock/security/glass{
	dir = 4;
	name = "Шлюз";
	req_access_txt = "12"
	},
/obj/machinery/atmospherics/pipe/simple/supply/hidden/layer2{
	dir = 8
	},
/obj/structure/cable{
	icon_state = "4-8"
	},
/obj/machinery/door/firedoor/border_only{
	dir = 8
	},
/obj/machinery/door/firedoor/border_only{
	dir = 4
	},
/turf/open/floor/plasteel/mono/dark,
/area/ship/bridge)
"l" = (
/obj/structure/catwalk,
/obj/effect/decal/cleanable/dirt,
/obj/machinery/porta_turret/ship/inteq{
	dir = 5;
	id = "iron2_turrets"
	},
/turf/closed/wall/mineral/plastitanium/nodiagonal,
/area/ship/bridge)
"m" = (
/obj/effect/turf_decal/industrial/warning{
	dir = 4
	},
/obj/machinery/door/firedoor/border_only{
	dir = 4
	},
/obj/machinery/door/poddoor/shutters{
	dir = 4;
	id = "Iron_maiden_cargo";
	name = "Cargo Shutter"
	},
/obj/machinery/door/firedoor/border_only{
	dir = 8
	},
/obj/effect/turf_decal/trimline/opaque/solgovgold/arrow_ccw{
	dir = 1
	},
/obj/machinery/atmospherics/pipe/simple/supply/hidden/layer2{
	dir = 8
	},
/obj/structure/fans/tiny/invisible,
/obj/docking_port/mobile{
	dir = 2;
	launch_status = 0;
	port_direction = 8;
	preferred_direction = 4;
	set_dir_on_move = 4
	},
/turf/open/floor/plasteel/tech/grid,
/area/ship/bridge)
"n" = (
/obj/machinery/porta_turret/ship/inteq{
	dir = 6;
	id = "iron2_turrets"
	},
/turf/closed/wall/mineral/plastitanium/nodiagonal,
/area/ship/bridge)
"o" = (
/obj/structure/table/reinforced,
/obj/machinery/recharger{
	pixel_x = -5;
	pixel_y = 8
	},
/obj/effect/turf_decal/corner/opaque/brown{
	dir = 4
	},
/obj/effect/turf_decal/corner/opaque/yellow{
	dir = 1
	},
/obj/item/spacecash/bundle/c500{
	pixel_y = -10
	},
/obj/item/spacecash/bundle/c500{
	pixel_y = -3;
	pixel_x = 3
	},
/obj/item/gun/energy/disabler{
	pixel_y = 5;
	pixel_x = 7
	},
/obj/item/reagent_containers/food/drinks/bottle/whiskey{
	pixel_x = -12
	},
/obj/item/stamp/inteq{
	layer = 4;
	pixel_x = 10
	},
/obj/machinery/turretid/ship{
	dir = 8;
	pixel_x = -9;
	id = "iron2_turrets";
	pixel_y = 25
	},
/obj/machinery/newscaster/directional/west{
	pixel_y = 39;
	pixel_x = 6;
	dir = 1
	},
/obj/machinery/button/door{
	id = "iron_maiden_bridge";
	name = "Фронтальные задвижки";
	pixel_x = 6;
	pixel_y = 23
	},
/obj/structure/window/plasma/reinforced/spawner/west,
/turf/open/floor/plasteel/tech,
/area/ship/bridge)
"p" = (
/obj/machinery/power/smes/shuttle/precharged{
	dir = 1
	},
/obj/structure/cable{
	icon_state = "0-8"
	},
/obj/machinery/door/poddoor{
	id = "iron_maiden_eng";
	name = "Engine Blast Door"
	},
/turf/open/floor/plating/ship,
/area/ship/bridge)
"q" = (
/obj/effect/turf_decal/trimline/opaque/solgovgold/arrow_ccw{
	dir = 1
	},
/obj/effect/turf_decal/box,
/obj/machinery/atmospherics/pipe/manifold/scrubbers/hidden/layer4,
/obj/machinery/atmospherics/pipe/simple/supply/hidden/layer2{
	dir = 8
	},
/obj/structure/cable{
	icon_state = "4-8"
	},
/obj/machinery/holopad,
/turf/open/floor/plasteel/mono/dark,
/area/ship/bridge)
"r" = (
/obj/machinery/cryopod{
	dir = 8
	},
/obj/machinery/computer/cryopod/directional/east,
/obj/machinery/light/directional/south,
/turf/open/floor/carpet/black,
/area/ship/bridge)
"s" = (
/obj/machinery/atmospherics/components/unary/vent_pump/on/layer2{
	dir = 8
	},
/obj/structure/cable{
	icon_state = "1-8"
	},
/obj/item/stack/cable_coil/red,
/turf/open/floor/plasteel/mono/dark,
/area/ship/bridge)
"t" = (
/obj/structure/cable{
	icon_state = "0-4"
	},
/obj/machinery/power/shuttle/engine/electric{
	dir = 4
	},
/turf/open/floor/plating/ship,
/area/ship/bridge)
"u" = (
/obj/machinery/power/smes/shuttle/precharged{
	dir = 4
	},
/obj/machinery/door/window/eastright{
	name = "Engine Access";
	dir = 1
	},
/obj/structure/window/plasma/reinforced/spawner/west{
	dir = 2
	},
/obj/structure/window/plasma/reinforced/spawner/west,
/obj/machinery/door/poddoor{
	id = "iron_maiden_eng";
	name = "Engine Blast Door"
	},
/obj/structure/cable{
	icon_state = "0-8"
	},
/turf/open/floor/plating,
/area/ship/bridge)
"v" = (
/obj/structure/catwalk,
/obj/structure/marker_beacon{
	picked_color = "Lime"
	},
/turf/open/floor/plasteel/tech/grid,
/area/ship/bridge)
"w" = (
/obj/structure/table/reinforced,
/obj/machinery/fax/admin/inteq{
	density = 0;
	visible_to_network = 1
	},
/obj/effect/turf_decal/corner/opaque/brown{
	dir = 4
	},
/obj/effect/turf_decal/corner/opaque/yellow{
	dir = 1
	},
/obj/effect/turf_decal/corner/opaque/yellow{
	dir = 4
	},
/obj/machinery/light/directional/north,
/turf/open/floor/plasteel/tech,
/area/ship/bridge)
"x" = (
/obj/effect/spawner/structure/window/plasma/reinforced/plastitanium,
/obj/machinery/door/poddoor/shutters/preopen{
	dir = 4;
	id = "iron_maiden_bridge";
	name = "Blast Shutters"
	},
/turf/open/floor/plating,
/area/ship/bridge)
"y" = (
/obj/machinery/power/shuttle/engine/electric{
	dir = 4
	},
/obj/structure/cable{
	icon_state = "0-4"
	},
/turf/open/floor/plating,
/area/ship/bridge)
"z" = (
/obj/machinery/airalarm/directional/east,
/turf/open/floor/plasteel/mono/dark,
/area/ship/bridge)
"A" = (
/obj/effect/turf_decal/corner/opaque/brown{
	dir = 4
	},
/obj/effect/turf_decal/corner/opaque/yellow,
/obj/machinery/light/directional/south,
/obj/machinery/computer/cargo{
	dir = 8
	},
/turf/open/floor/plasteel/tech,
/area/ship/bridge)
"B" = (
/obj/machinery/power/port_gen/pacman/super{
	anchored = 1
	},
/obj/effect/turf_decal/siding/thinplating/dark{
	dir = 4
	},
/obj/effect/turf_decal/industrial/outline/yellow,
/obj/machinery/button/door{
	dir = 4;
	id = "iron_maiden_eng";
	name = "Двигательные задвижки";
	pixel_x = -23
	},
/obj/machinery/light_switch{
	pixel_x = -22;
	dir = 4;
	pixel_y = 9
	},
/obj/item/stack/sheet/mineral/uranium/twenty,
/obj/machinery/power/terminal{
	dir = 1
	},
/obj/structure/cable{
	icon_state = "0-8"
	},
/turf/open/floor/plating,
/area/ship/bridge)
"C" = (
/obj/structure/grille,
/turf/open/floor/engine/hull/reinforced,
/area/ship/bridge)
"D" = (
/obj/machinery/porta_turret/ship/inteq{
	dir = 9;
	id = "iron2_turrets"
	},
/turf/closed/wall/mineral/plastitanium/nodiagonal,
/area/ship/bridge)
"E" = (
/obj/machinery/atmospherics/components/unary/outlet_injector/on/layer4{
	dir = 4
	},
/obj/effect/turf_decal/trimline/opaque/solgovgold/arrow_cw,
/obj/effect/turf_decal/trimline/opaque/solgovgold/warning{
	dir = 4
	},
/obj/machinery/atmospherics/components/unary/vent_scrubber/on/layer2{
	dir = 4
	},
/obj/docking_port/stationary{
	dwidth = 15;
	height = 15;
	width = 30;
	dir = 8
	},
/turf/open/floor/plasteel/tech/grid,
/area/ship/bridge)
"F" = (
/obj/structure/catwalk,
/turf/open/floor/plasteel/tech/grid,
/area/ship/bridge)
"G" = (
/turf/open/floor/plasteel/mono/white,
/area/ship/bridge)
"H" = (
/obj/effect/turf_decal/borderfloorwhite,
/obj/structure/closet/secure_closet/wall{
	icon_door = "med_wall";
	name = "medical locker";
	req_access_txt = "5";
	dir = 8;
	pixel_x = -28
	},
/obj/item/storage/firstaid/advanced{
	pixel_x = -6;
	pixel_y = -3
	},
/obj/item/stack/medical/splint{
	pixel_x = 6
	},
/obj/item/storage/pill_bottle/iron{
	pixel_x = 6
	},
/obj/item/defibrillator/loaded,
/obj/item/roller,
/obj/item/clothing/under/syndicate/inteq/corpsman/skirt,
/obj/item/gun/energy/e_gun/mini,
/obj/item/clothing/under/syndicate/inteq/corpsman,
/obj/item/clothing/head/soft/inteq/corpsman,
/obj/item/clothing/glasses/hud/health,
/obj/item/clothing/suit/armor/inteq/corpsman,
/obj/item/storage/backpack/satchel/med,
/obj/item/storage/belt/medical/webbing,
/obj/item/clothing/shoes/combat,
/obj/structure/cable{
	icon_state = "1-2"
	},
/obj/item/storage/case/surgery,
/turf/open/floor/plasteel/tech,
/area/ship/bridge)
"I" = (
/obj/structure/cable{
	icon_state = "1-2"
	},
/obj/item/storage/toolbox/mechanical/old,
/turf/open/floor/plasteel/mono/dark,
/area/ship/bridge)
"J" = (
/obj/machinery/atmospherics/pipe/manifold/supply/hidden/layer2,
/obj/structure/cable{
	icon_state = "2-8"
	},
/obj/structure/cable{
	icon_state = "4-8"
	},
/turf/open/floor/plasteel/mono/dark,
/area/ship/bridge)
"K" = (
/obj/machinery/porta_turret/ship/inteq{
	dir = 10;
	id = "iron2_turrets"
	},
/turf/closed/wall/mineral/plastitanium/nodiagonal,
/area/ship/bridge)
"L" = (
/obj/effect/turf_decal/siding/thinplating/dark{
	dir = 4
	},
/obj/effect/turf_decal/industrial/hatch/yellow,
/obj/machinery/power/ship_gravity,
/obj/structure/cable{
	icon_state = "0-8"
	},
/obj/structure/cable{
	icon_state = "2-8"
	},
/turf/open/floor/plasteel/tech/grid,
/area/ship/bridge)
"M" = (
/obj/structure/marker_beacon{
	picked_color = "Lime"
	},
/obj/structure/catwalk,
/turf/open/floor/engine/hull/reinforced,
/area/ship/bridge)
"N" = (
/obj/effect/turf_decal/siding/brown,
/obj/item/flashlight/seclite,
/obj/item/clothing/glasses/hud/security/sunglasses/inteq,
/obj/item/gun/ballistic/automatic/pistol/glock,
/obj/item/gun/ballistic/automatic/assault/g36/inteq,
/obj/item/ammo_box/magazine/g36,
/obj/item/ammo_box/magazine/g36,
/obj/item/ammo_box/magazine/g36,
/obj/item/ammo_box/magazine/g36,
/obj/item/gun/ballistic/automatic/smg/skm_carbine/inteq,
/obj/item/ammo_box/magazine/smgm10mm,
/obj/item/ammo_box/magazine/smgm10mm,
/obj/item/ammo_box/magazine/smgm10mm,
/obj/item/gun/ballistic/automatic/pistol/glock,
/obj/item/gun/ballistic/automatic/pistol/usp45,
/obj/structure/closet/secure_closet/empty/warden{
	name = "\proper Weapons Locker"
	},
/turf/open/floor/plasteel/mono/dark,
/area/ship/bridge)
"O" = (
/turf/closed/wall/mineral/plastitanium/nodiagonal,
/area/ship/bridge)
"P" = (
/obj/structure/chair/comfy/shuttle{
	dir = 4;
	name = "Helm"
	},
/obj/machinery/atmospherics/components/unary/vent_pump/on/layer2,
/obj/structure/catwalk/over/plated_catwalk/dark,
/obj/structure/window/plasma/reinforced/spawner/west,
/turf/open/floor/plating,
/area/ship/bridge)
"Q" = (
/obj/machinery/porta_turret/ship/inteq{
	id = "iron2_turrets"
	},
/turf/closed/wall/mineral/plastitanium/nodiagonal,
/area/ship/bridge)
"R" = (
/obj/machinery/suit_storage_unit/inherit{
	req_access_txt = "147"
	},
/obj/item/clothing/suit/space/hardsuit/security/independent/inteq,
/obj/item/tank/jetpack/oxygen,
/obj/item/clothing/mask/gas/sechailer,
/obj/effect/turf_decal/siding/brown,
/obj/structure/sign/poster/contraband/inteq{
	pixel_y = -32
	},
/obj/machinery/light/directional/south,
/obj/item/tank/internals/emergency_oxygen/double,
/turf/open/floor/plasteel/mono/dark,
/area/ship/bridge)
"S" = (
/obj/structure/grille,
/turf/open/space/basic,
/area/ship/bridge)
"T" = (
/obj/machinery/power/terminal,
/obj/machinery/firealarm/directional/west,
/obj/structure/cable,
/obj/effect/turf_decal/siding/brown{
	dir = 10
	},
/obj/structure/chair/comfy/shuttle{
	dir = 1
	},
/turf/open/floor/plasteel/mono/dark,
/area/ship/bridge)
"U" = (
/obj/machinery/suit_storage_unit/inherit{
	req_access_txt = "147"
	},
/obj/item/clothing/suit/space/hardsuit/security/independent/inteq,
/obj/item/tank/jetpack/oxygen,
/obj/item/clothing/mask/gas/sechailer,
/obj/effect/turf_decal/siding/brown{
	dir = 1
	},
/obj/machinery/atmospherics/components/unary/vent_scrubber/on/layer4,
/obj/structure/sign/poster/contraband/inteq_gec{
	pixel_x = 1;
	pixel_y = 30
	},
/obj/item/tank/internals/emergency_oxygen/double,
/turf/open/floor/plasteel/mono/dark,
/area/ship/bridge)
"V" = (
/obj/structure/curtain/bounty,
/obj/machinery/door/firedoor/border_only{
	dir = 8
	},
/obj/structure/closet/secure_closet/wall{
	icon_state = "generic_wall";
	name = "equipment locker";
	pixel_y = -28
	},
/obj/item/storage/ration/assorted_salted_offal,
/obj/item/storage/ration/beef_strips,
/obj/item/storage/ration/chili_macaroni,
/obj/item/storage/ration/crayons,
/obj/item/storage/ration/lemon_pepper_chicken,
/obj/item/storage/ration/vegan_chili,
/obj/item/storage/ration/vegan_chili,
/obj/item/storage/ration/shredded_beef,
/obj/item/storage/ration/sausage_peppers_onions,
/obj/item/storage/ration/fish_stew,
/turf/open/floor/plasteel/mono/dark,
/area/ship/bridge)
"W" = (
/obj/machinery/power/smes/engineering,
/obj/effect/turf_decal/siding/thinplating/dark{
	dir = 5
	},
/obj/machinery/atmospherics/pipe/simple/supply/hidden/layer2{
	dir = 6
	},
/obj/structure/cable{
	icon_state = "1-4"
	},
/obj/structure/cable,
/turf/open/floor/plasteel/tech/grid,
/area/ship/bridge)
"X" = (
/obj/machinery/power/terminal{
	dir = 1
	},
/obj/machinery/button/door{
	name = "Cargo Doors";
	id = "Iron_maiden_cargo";
	dir = 4;
	pixel_x = -20;
	req_access_txt = "12";
	req_ship_access = 1
	},
/obj/structure/cable{
	icon_state = "0-2"
	},
/obj/effect/turf_decal/siding/brown{
	dir = 9
	},
/obj/structure/chair/comfy/shuttle,
/obj/machinery/atmospherics/components/unary/vent_pump/on/layer2,
/turf/open/floor/plasteel/mono/dark,
/area/ship/bridge)
"Y" = (
/obj/machinery/power/smes/shuttle/precharged,
/obj/structure/cable{
	icon_state = "0-8"
	},
/obj/machinery/door/poddoor{
	id = "iron_maiden_eng";
	name = "Engine Blast Door"
	},
/obj/structure/cable{
	icon_state = "0-2"
	},
/obj/structure/fans/tiny/invisible,
/turf/open/floor/plating/ship,
/area/ship/bridge)
"Z" = (
/turf/open/floor/plasteel/patterned/ridged,
/area/ship/bridge)

(1,1,1) = {"
M
Z
e
E
e
Z
M
"}
(2,1,1) = {"
D
y
O
m
O
y
K
"}
(3,1,1) = {"
C
b
X
g
T
u
S
"}
(4,1,1) = {"
v
O
U
q
R
O
v
"}
(5,1,1) = {"
F
O
d
f
N
O
F
"}
(6,1,1) = {"
t
O
O
k
O
O
a
"}
(7,1,1) = {"
Y
W
B
J
H
h
p
"}
(8,1,1) = {"
O
L
I
s
z
G
Q
"}
(9,1,1) = {"
O
o
P
j
O
V
O
"}
(10,1,1) = {"
O
w
c
A
O
r
O
"}
(11,1,1) = {"
l
O
x
i
O
O
n
"}
