//MAP CONVERTED BY dmm2tgm.py THIS HEADER COMMENT PREVENTS RECONVERSION, DO NOT REMOVE
"al" = (
/obj/machinery/atmospherics/components/unary/vent_scrubber/on/layer4,
/turf/open/floor/carpet/nanoweave,
/area/ship/maintenance/central)
"cx" = (
/turf/closed/wall/mineral/titanium/nodiagonal,
/area/ship/maintenance/central)
"cy" = (
/obj/machinery/telecomms/relay{
	network = "all_broadcast"
	},
/turf/open/floor/plasteel/telecomms_floor,
/area/ship/maintenance/central)
"dc" = (
/obj/machinery/telecomms/hub{
	network = "all_broadcast"
	},
/obj/machinery/light/directional/east{
	pixel_x = 36
	},
/turf/open/floor/plasteel/telecomms_floor,
/area/ship/maintenance/central)
"dk" = (
/obj/machinery/telecomms/receiver{
	network = "all_broadcast"
	},
/obj/structure/window/bronze{
	dir = 1
	},
/turf/open/floor/plasteel/telecomms_floor,
/area/ship/maintenance/central)
"eU" = (
/obj/structure/cable{
	icon_state = "1-2"
	},
/obj/structure/cable{
	icon_state = "0-8"
	},
/obj/machinery/power/terminal{
	icon_state = "term";
	dir = 8
	},
/obj/machinery/power/port_gen/pacman{
	anchored = 1
	},
/obj/item/stack/sheet/mineral/plasma/fifty,
/obj/effect/decal/cleanable/plasma,
/turf/open/floor/plasteel,
/area/ship/maintenance/central)
"fj" = (
/obj/structure/curtain/cloth/grey,
/obj/item/bedsheet/dorms,
/obj/structure/bed,
/obj/structure/window/reinforced/tinted/frosted,
/turf/open/floor/carpet/nanoweave,
/area/ship/crew/cryo)
"fm" = (
/obj/machinery/atmospherics/pipe/simple/scrubbers/hidden/layer4{
	icon_state = "pipe11-4";
	dir = 5
	},
/turf/closed/wall/mineral/titanium/nodiagonal,
/area/ship/maintenance/central)
"fP" = (
/obj/item/radio/intercom/wideband/directional/south,
/obj/structure/table/bronze,
/obj/machinery/button/door{
	id = 34563;
	name = "Окна";
	pixel_y = -5;
	pixel_x = -8
	},
/obj/item/reagent_containers/food/drinks/coffee{
	pixel_x = 7;
	pixel_y = -2
	},
/obj/machinery/jukebox/boombox{
	pixel_x = -2;
	pixel_y = 1
	},
/turf/open/floor/carpet/nanoweave/blue,
/area/ship/bridge)
"hy" = (
/obj/effect/spawner/structure/window/shuttle,
/obj/machinery/door/poddoor/shutters{
	id = 34563
	},
/turf/open/floor/plating,
/area/ship/maintenance/central)
"hT" = (
/obj/structure/table/bronze,
/obj/item/reagent_containers/food/condiment/saltshaker{
	pixel_y = 8;
	pixel_x = 9
	},
/obj/item/reagent_containers/food/condiment/peppermill{
	pixel_x = 9
	},
/obj/item/kitchen/knife{
	pixel_x = 4
	},
/obj/item/cutting_board{
	pixel_x = -1;
	pixel_y = 3
	},
/obj/structure/window/reinforced/tinted/frosted{
	dir = 4;
	pixel_x = 6
	},
/turf/open/floor/carpet/nanoweave/beige,
/area/ship/maintenance/central)
"iv" = (
/obj/machinery/atmospherics/pipe/simple/scrubbers/hidden/layer4{
	dir = 4
	},
/obj/machinery/atmospherics/pipe/manifold/supply/hidden/layer2,
/obj/structure/cable{
	icon_state = "4-8"
	},
/turf/open/floor/carpet/nanoweave/red,
/area/ship/maintenance/central)
"lq" = (
/obj/machinery/vending/cigarette{
	density = 0;
	pixel_y = 31;
	pixel_x = -4
	},
/obj/machinery/vending/wallmed{
	pixel_y = 32;
	pixel_x = 12
	},
/obj/structure/closet/wall/orange/directional/west{
	pixel_y = 7
	},
/obj/item/clothing/gloves/color/yellow,
/obj/item/clothing/glasses/welding,
/obj/item/storage/belt/utility/full,
/obj/item/clothing/under/rank/engineering/engineer/nt,
/obj/item/clothing/shoes/workboots,
/obj/item/stack/sheet/glass/twenty,
/obj/item/pickaxe/mini,
/obj/item/clothing/glasses/meson/engine,
/obj/item/stack/sheet/metal/fifty,
/obj/item/clothing/gloves/color/latex/engineering,
/obj/item/clothing/suit/hooded/enginseer{
	armor = list("melee" = 50, "bullet" = 40, "laser" = 50, "energy" = 50, "bomb" = 25, "bio" = 0, "rad" = 0, "fire" = 100, "acid" = 90)
	},
/turf/open/floor/carpet/nanoweave,
/area/ship/maintenance/central)
"lU" = (
/obj/machinery/telecomms/bus{
	network = "all_broadcast"
	},
/obj/structure/window/bronze{
	dir = 8
	},
/obj/structure/window/bronze{
	dir = 1
	},
/turf/open/floor/plasteel/telecomms_floor,
/area/ship/maintenance/central)
"mL" = (
/turf/closed/wall/mineral/titanium/nodiagonal,
/area/ship/crew/office)
"mM" = (
/turf/closed/wall/mineral/titanium/nodiagonal,
/area/ship/crew/cryo)
"nI" = (
/obj/machinery/atmospherics/components/unary/vent_scrubber/on/layer4{
	dir = 8
	},
/obj/structure/cable{
	icon_state = "4-8"
	},
/obj/structure/cable{
	icon_state = "1-8"
	},
/turf/open/floor/carpet/nanoweave/blue,
/area/ship/bridge)
"nW" = (
/obj/structure/table/bronze,
/obj/item/paper_bin{
	pixel_x = 6;
	pixel_y = 1
	},
/obj/item/pen/fourcolor{
	pixel_x = 6
	},
/obj/item/stamp/captain{
	pixel_x = -9;
	pixel_y = 11
	},
/obj/item/stamp/denied{
	pixel_x = -8;
	pixel_y = 5
	},
/obj/item/stamp{
	pixel_x = -7;
	pixel_y = -1
	},
/obj/item/kitchen/knife/letter_opener{
	pixel_x = -1;
	pixel_y = 8
	},
/obj/machinery/newscaster/directional/south,
/turf/open/floor/carpet/nanoweave/orange,
/area/ship/crew/office)
"nY" = (
/obj/machinery/power/apc/auto_name/directional/west,
/obj/machinery/power/terminal{
	icon_state = "term";
	dir = 8
	},
/obj/structure/cable{
	icon_state = "0-4"
	},
/obj/machinery/portable_atmospherics/canister/air,
/obj/machinery/atmospherics/components/unary/portables_connector/layer2{
	dir = 4
	},
/obj/machinery/light_switch{
	pixel_y = 12;
	pixel_x = -19;
	dir = 4
	},
/obj/structure/closet/emcloset/wall/directional/west{
	pixel_x = -34;
	name = "Emergency space suits"
	},
/obj/item/clothing/head/helmet/space/eva,
/obj/item/clothing/head/helmet/space/eva,
/obj/item/clothing/suit/space/eva,
/obj/item/clothing/suit/space/eva,
/obj/item/tank/internals/oxygen/red,
/obj/item/tank/internals/oxygen/red,
/turf/open/floor/plasteel,
/area/ship/maintenance/central)
"oS" = (
/obj/structure/chair/comfy/shuttle/bronze{
	dir = 4
	},
/obj/structure/cable{
	icon_state = "4-8"
	},
/turf/open/floor/carpet/nanoweave/blue,
/area/ship/bridge)
"oZ" = (
/obj/machinery/button/door{
	id = "lock_dockp";
	pixel_y = 23;
	pixel_x = -7;
	specialfunctions = 4;
	normaldoorcontrol = 1
	},
/obj/structure/closet/secure_closet/freezer,
/obj/item/reagent_containers/food/snacks/meat/slab/monkey,
/obj/item/reagent_containers/food/snacks/meat/slab/monkey,
/obj/item/reagent_containers/food/snacks/meat/slab/monkey,
/obj/item/reagent_containers/food/snacks/meat/slab/monkey,
/obj/item/reagent_containers/food/snacks/meat/slab/monkey,
/obj/item/reagent_containers/food/snacks/meat/slab/monkey,
/obj/item/reagent_containers/food/condiment/milk,
/obj/item/reagent_containers/food/condiment/milk,
/obj/item/reagent_containers/food/condiment/soymilk,
/obj/item/reagent_containers/food/condiment/soymilk,
/obj/item/reagent_containers/food/condiment/enzyme,
/obj/structure/extinguisher_cabinet/directional/north{
	pixel_x = 3
	},
/obj/machinery/light/directional/east{
	pixel_x = 36
	},
/obj/machinery/light_switch{
	pixel_y = 21;
	pixel_x = 11
	},
/obj/item/storage/fancy/egg_box,
/obj/item/storage/fancy/egg_box,
/obj/machinery/newscaster/directional/east{
	pixel_x = 31
	},
/obj/item/storage/box/ingredients/fruity,
/obj/item/storage/box/ingredients/carnivore,
/obj/item/storage/box/ingredients/delights,
/turf/open/floor/carpet/nanoweave/beige,
/area/ship/maintenance/central)
"ps" = (
/obj/machinery/shower{
	icon_state = "shower";
	dir = 8;
	pixel_x = -6;
	pixel_y = -3
	},
/obj/machinery/door/window/westright,
/obj/item/soap/deluxe{
	pixel_x = -1;
	pixel_y = -6
	},
/obj/structure/window/reinforced/tinted/frosted,
/obj/item/towel,
/turf/open/floor/plasteel/white,
/area/ship/crew/cryo)
"qc" = (
/obj/structure/closet/wall/directional/north{
	pixel_x = -7
	},
/obj/machinery/vending/clothing{
	density = 0;
	pixel_x = 13;
	pixel_y = 31
	},
/obj/structure/cable{
	icon_state = "2-4";
	tag = null
	},
/obj/item/tank/internals/emergency_oxygen/double,
/obj/item/tank/internals/emergency_oxygen/double,
/obj/item/flashlight/seclite,
/obj/item/flashlight/seclite,
/obj/item/flashlight/seclite,
/obj/item/tank/internals/emergency_oxygen/double,
/turf/open/floor/carpet/nanoweave,
/area/ship/crew/cryo)
"qs" = (
/obj/machinery/power/shuttle/engine/electric/tech1{
	dir = 4
	},
/obj/structure/cable{
	icon_state = "0-4"
	},
/turf/open/floor/plating,
/area/ship/maintenance/central)
"qM" = (
/obj/machinery/telecomms/broadcaster{
	network = "all_broadcast"
	},
/obj/structure/window/bronze{
	dir = 1
	},
/turf/open/floor/plasteel/telecomms_floor,
/area/ship/maintenance/central)
"rf" = (
/obj/machinery/power/terminal{
	icon_state = "term";
	dir = 8
	},
/obj/structure/cable{
	icon_state = "0-1"
	},
/obj/structure/closet/crate/secure/loot,
/obj/item/clothing/head/bronze,
/obj/item/clothing/shoes/bronze,
/obj/item/clothing/suit/bronze,
/obj/item/toy/plush/plushvar,
/obj/item/nullrod/spear,
/obj/machinery/light/directional/south,
/turf/open/floor/plasteel,
/area/ship/maintenance/central)
"uV" = (
/turf/closed/wall/mineral/titanium/nodiagonal,
/area/ship/bridge)
"vh" = (
/obj/structure/window/bronze{
	dir = 4
	},
/obj/structure/window/bronze{
	dir = 1
	},
/obj/structure/table/bronze,
/obj/machinery/fax,
/turf/open/floor/carpet/nanoweave/orange,
/area/ship/crew/office)
"vv" = (
/obj/machinery/door/airlock/external/glass{
	id_tag = "lock_dockp";
	glass = 0
	},
/obj/structure/fans/tiny,
/obj/docking_port/mobile{
	dir = 2;
	port_direction = 8;
	preferred_direction = 4
	},
/turf/open/floor/plating,
/area/ship/maintenance/central)
"wL" = (
/obj/machinery/computer/helm{
	icon_state = "computer-middle";
	dir = 8;
	pixel_x = 7
	},
/obj/structure/cable{
	icon_state = "1-8"
	},
/mob/living/simple_animal/parrot/Polly{
	name = "Carl";
	desc = "Carl the Parrot. The most annoying creature in the universe."
	},
/turf/open/floor/carpet/nanoweave/blue,
/area/ship/bridge)
"xI" = (
/obj/structure/closet/wall/blue/directional/north,
/obj/structure/table/bronze,
/obj/item/megaphone/command,
/obj/item/binoculars,
/obj/item/gun/ballistic/automatic/pistol/commissar,
/obj/item/ammo_box/c9mm,
/obj/item/ammo_box/magazine/co9mm,
/obj/item/ammo_box/magazine/co9mm,
/obj/item/storage/firstaid/medical,
/obj/item/clothing/suit/armor/vest/capcarapace/duster,
/obj/item/ammo_box/magazine/co9mm/inc,
/obj/structure/window/reinforced/tinted/frosted{
	dir = 8;
	pixel_x = -4
	},
/obj/item/clothing/under/syndicate,
/turf/open/floor/carpet/nanoweave/blue,
/area/ship/bridge)
"xL" = (
/obj/machinery/atmospherics/components/unary/passive_vent/layer4,
/obj/effect/turf_decal/industrial/warning/fulltile,
/obj/item/toy/plush/narplush,
/turf/open/floor/plating,
/area/ship/maintenance/central)
"zU" = (
/obj/machinery/power/apc/auto_name/directional/south,
/obj/machinery/power/terminal,
/obj/structure/cable,
/obj/machinery/light_switch{
	pixel_y = -16;
	pixel_x = -12;
	dir = 1
	},
/obj/item/clothing/suit/det_suit,
/obj/item/clothing/neck/tie/detective,
/obj/item/clothing/head/fedora/det_hat,
/obj/item/gun/ballistic/revolver/detective,
/obj/item/clothing/accessory/holster/detective{
	pixel_y = 5
	},
/obj/item/camera/detective,
/obj/item/detective_scanner,
/obj/item/ammo_box/c38/dumdum,
/obj/item/ammo_box/c38/iceblox,
/obj/structure/closet/wall/directional/south{
	pixel_x = 5;
	pixel_y = -32
	},
/obj/item/clothing/under/rank/security/detective,
/turf/open/floor/carpet/nanoweave/orange,
/area/ship/crew/office)
"zX" = (
/obj/machinery/telecomms/server{
	network = "all_broadcast"
	},
/turf/open/floor/plasteel/telecomms_floor,
/area/ship/maintenance/central)
"Aj" = (
/obj/effect/spawner/structure/window/shuttle,
/obj/machinery/door/poddoor/shutters{
	dir = 4;
	id = 34563
	},
/turf/open/floor/plating,
/area/ship/bridge)
"Ay" = (
/obj/effect/decal/cleanable/food/flour,
/turf/open/floor/carpet/nanoweave/beige,
/area/ship/maintenance/central)
"AC" = (
/obj/machinery/holopad/emergency/command,
/obj/structure/cable{
	icon_state = "4-8"
	},
/turf/open/floor/carpet/nanoweave/blue,
/area/ship/bridge)
"Bk" = (
/obj/machinery/computer/cargo/express{
	icon_state = "computer-left";
	dir = 8;
	pixel_x = 7
	},
/obj/machinery/light/small/directional/north{
	pixel_x = -12
	},
/obj/machinery/power/apc/auto_name/directional/north,
/obj/machinery/power/terminal{
	dir = 1
	},
/obj/structure/cable{
	d2 = 2;
	icon_state = "0-2";
	pixel_y = 1
	},
/obj/machinery/light_switch{
	pixel_y = 21;
	pixel_x = 11
	},
/obj/machinery/newscaster/directional/north{
	pixel_y = 42;
	pixel_x = -8
	},
/turf/open/floor/carpet/nanoweave/blue,
/area/ship/bridge)
"Bz" = (
/turf/open/floor/carpet/nanoweave,
/area/ship/maintenance/central)
"BQ" = (
/obj/structure/window/bronze{
	dir = 8
	},
/turf/open/floor/plasteel/telecomms_floor,
/area/ship/maintenance/central)
"Cy" = (
/obj/machinery/door/window/westright,
/obj/machinery/atmospherics/pipe/simple/scrubbers/hidden/layer4{
	dir = 4
	},
/obj/machinery/atmospherics/components/unary/vent_pump/on/layer2{
	dir = 8
	},
/obj/structure/cable{
	icon_state = "4-8"
	},
/obj/structure/cable{
	icon_state = "2-8"
	},
/turf/open/floor/carpet/nanoweave/blue,
/area/ship/bridge)
"DH" = (
/obj/machinery/door/window{
	dir = 4
	},
/turf/open/floor/plasteel/telecomms_floor,
/area/ship/maintenance/central)
"DO" = (
/obj/machinery/computer/telecomms/monitor{
	network = "all_broadcast"
	},
/obj/structure/window/bronze{
	dir = 4
	},
/obj/structure/window/bronze{
	dir = 1
	},
/turf/open/floor/plasteel/telecomms_floor,
/area/ship/maintenance/central)
"EB" = (
/turf/open/floor/plasteel/telecomms_floor,
/area/ship/maintenance/central)
"Gr" = (
/obj/structure/cable{
	icon_state = "1-2"
	},
/obj/structure/cable{
	icon_state = "2-8"
	},
/obj/machinery/atmospherics/pipe/simple/scrubbers/hidden/layer4,
/obj/machinery/atmospherics/pipe/simple/supply/hidden/layer2{
	icon_state = "pipe11-2";
	dir = 10
	},
/obj/machinery/power/ship_gravity,
/obj/structure/cable{
	d2 = 2;
	icon_state = "0-2";
	pixel_y = 1
	},
/turf/open/floor/plasteel,
/area/ship/maintenance/central)
"GA" = (
/obj/structure/cable{
	icon_state = "1-2"
	},
/obj/structure/cable{
	icon_state = "1-8"
	},
/obj/machinery/atmospherics/pipe/simple/scrubbers/hidden/layer4{
	icon_state = "pipe11-4";
	dir = 5
	},
/obj/machinery/atmospherics/pipe/simple/supply/hidden/layer2{
	dir = 5
	},
/obj/effect/decal/cleanable/plasma,
/obj/structure/cable{
	icon_state = "2-4";
	tag = null
	},
/obj/item/stock_parts/capacitor/super{
	pixel_y = -13;
	pixel_x = -8
	},
/obj/item/stock_parts/micro_laser/ultra{
	pixel_y = -11;
	pixel_x = 7
	},
/obj/item/paper/crumpled{
	default_raw_text = "новые запчасти для пакмэна, на установку не было времени"
	},
/turf/open/floor/carpet/nanoweave/red,
/area/ship/maintenance/central)
"HX" = (
/obj/effect/decal/cleanable/ash{
	pixel_x = 9;
	pixel_y = 5
	},
/turf/open/floor/carpet/nanoweave/beige,
/area/ship/maintenance/central)
"IF" = (
/obj/effect/decal/cleanable/vomit,
/turf/open/floor/carpet/nanoweave/beige,
/area/ship/maintenance/central)
"IN" = (
/obj/structure/cable{
	icon_state = "2-4"
	},
/obj/effect/decal/cleanable/plasma,
/turf/open/floor/carpet/nanoweave/red,
/area/ship/maintenance/central)
"IZ" = (
/obj/structure/fans/tiny,
/obj/machinery/door/airlock/external/glass{
	dir = 8;
	id_tag = "lock_airl";
	glass = 0
	},
/turf/open/floor/plating,
/area/ship/maintenance/central)
"JN" = (
/obj/structure/cable{
	icon_state = "0-4"
	},
/obj/machinery/power/shuttle/engine/electric/tech1{
	dir = 4
	},
/turf/open/floor/plating,
/area/ship/maintenance/central)
"Kq" = (
/obj/structure/cable{
	icon_state = "0-8"
	},
/obj/machinery/power/smes/shuttle/precharged{
	dir = 4
	},
/obj/structure/window/plasma/reinforced/spawner/west,
/obj/machinery/door/poddoor/shutters{
	dir = 4;
	id = 34563
	},
/turf/open/floor/plasteel,
/area/ship/maintenance/central)
"Ky" = (
/obj/machinery/computer/communications{
	icon_state = "computer-right";
	dir = 8;
	pixel_x = 7
	},
/obj/machinery/light/small/directional/south{
	pixel_x = -12
	},
/obj/machinery/airalarm/directional/south,
/turf/open/floor/carpet/nanoweave/blue,
/area/ship/bridge)
"KV" = (
/obj/machinery/door/window/westright{
	dir = 1
	},
/obj/structure/cable{
	icon_state = "1-2"
	},
/turf/open/floor/carpet/nanoweave/orange,
/area/ship/crew/office)
"LE" = (
/obj/item/paper/crumpled{
	default_raw_text = "Б/У машинерия, возможно нужна повторная настройка"
	},
/obj/item/multitool{
	pixel_x = -10
	},
/turf/open/floor/plasteel/telecomms_floor,
/area/ship/maintenance/central)
"NH" = (
/obj/structure/chair/sofa/brown/left{
	dir = 4
	},
/obj/item/toy/plush/lizardplushie{
	pixel_y = -8;
	pixel_x = 2
	},
/turf/open/floor/carpet/nanoweave,
/area/ship/maintenance/central)
"OV" = (
/obj/machinery/power/terminal{
	icon_state = "term";
	dir = 8
	},
/obj/structure/cable{
	icon_state = "0-2"
	},
/obj/machinery/atmospherics/pipe/simple/scrubbers/hidden/layer4,
/obj/machinery/airalarm/directional/north,
/obj/machinery/autolathe,
/obj/machinery/light/directional/north{
	pixel_y = 36
	},
/turf/open/floor/plasteel,
/area/ship/maintenance/central)
"Pe" = (
/obj/structure/table/bronze,
/obj/machinery/microwave,
/obj/structure/window/reinforced/tinted/frosted{
	dir = 4;
	pixel_x = 5
	},
/turf/open/floor/carpet/nanoweave/beige,
/area/ship/maintenance/central)
"PW" = (
/obj/structure/table/bronze,
/obj/item/lighter/clockwork{
	pixel_x = 7;
	pixel_y = -8
	},
/obj/item/storage/fancy/cigarettes/cigpack_syndicate{
	pixel_x = 10;
	pixel_y = 7
	},
/obj/machinery/light/directional/south,
/obj/item/toy/figure/detective{
	pixel_x = -6;
	pixel_y = 1
	},
/turf/open/floor/carpet/nanoweave/orange,
/area/ship/crew/office)
"Qe" = (
/obj/machinery/atmospherics/pipe/simple/scrubbers/hidden/layer4{
	dir = 4
	},
/obj/machinery/atmospherics/pipe/simple/supply/hidden/layer2{
	dir = 4
	},
/obj/structure/cable{
	icon_state = "4-8"
	},
/turf/open/floor/carpet/nanoweave/red,
/area/ship/maintenance/central)
"RL" = (
/obj/machinery/atmospherics/pipe/simple/scrubbers/hidden/layer4{
	icon_state = "pipe11-4";
	dir = 10
	},
/turf/closed/wall/mineral/titanium/nodiagonal,
/area/ship/maintenance/central)
"SV" = (
/obj/structure/window/bronze{
	dir = 1
	},
/obj/structure/chair/comfy/shuttle/bronze,
/turf/open/floor/carpet/nanoweave/orange,
/area/ship/crew/office)
"Uu" = (
/obj/machinery/button/door{
	id = "lock_airl";
	pixel_y = 7;
	pixel_x = -23;
	specialfunctions = 4;
	normaldoorcontrol = 1;
	dir = 4
	},
/obj/machinery/power/smes/engineering,
/obj/structure/cable{
	icon_state = "0-1"
	},
/turf/open/floor/plasteel,
/area/ship/maintenance/central)
"UC" = (
/turf/template_noop,
/area/template_noop)
"WY" = (
/obj/machinery/atmospherics/pipe/manifold/scrubbers/hidden/layer4,
/obj/machinery/atmospherics/pipe/simple/supply/hidden/layer2{
	dir = 4
	},
/obj/structure/cable{
	icon_state = "4-8"
	},
/turf/open/floor/carpet/nanoweave/red,
/area/ship/maintenance/central)
"Yi" = (
/obj/effect/decal/cleanable/food/egg_smudge,
/turf/open/floor/carpet/nanoweave,
/area/ship/maintenance/central)
"Yv" = (
/obj/structure/bed,
/obj/item/bedsheet/dorms,
/obj/structure/curtain/cloth/grey,
/obj/machinery/light/small/directional/north,
/obj/item/reagent_containers/food/drinks/bottle/absinthe/premium{
	pixel_x = -7;
	pixel_y = -6
	},
/turf/open/floor/carpet/nanoweave,
/area/ship/crew/cryo)
"YZ" = (
/obj/structure/cable{
	icon_state = "1-2"
	},
/obj/machinery/door/window/westright{
	dir = 2
	},
/turf/open/floor/carpet/nanoweave,
/area/ship/crew/cryo)
"Zo" = (
/obj/machinery/cryopod{
	dir = 8
	},
/obj/machinery/light/small/directional/north{
	pixel_x = 11;
	pixel_y = 36
	},
/obj/machinery/power/apc/auto_name/directional/north,
/obj/machinery/power/terminal{
	dir = 1
	},
/obj/machinery/light_switch{
	pixel_y = 21;
	pixel_x = 11
	},
/obj/structure/window/reinforced/tinted/frosted{
	pixel_y = -2
	},
/turf/open/floor/carpet/nanoweave,
/area/ship/crew/cryo)
"ZG" = (
/obj/machinery/telecomms/processor{
	network = "all_broadcast"
	},
/turf/open/floor/plasteel/telecomms_floor,
/area/ship/maintenance/central)
"ZT" = (
/obj/machinery/atmospherics/components/unary/vent_pump/on/layer2,
/obj/structure/chair/sofa/brown/right{
	dir = 4
	},
/turf/open/floor/carpet/nanoweave,
/area/ship/maintenance/central)

(1,1,1) = {"
UC
cx
qs
cx
IZ
cx
JN
cx
UC
"}
(2,1,1) = {"
xL
fm
Kq
nY
IN
Uu
Kq
cx
UC
"}
(3,1,1) = {"
cx
RL
OV
Gr
GA
eU
rf
cx
cx
"}
(4,1,1) = {"
cx
lq
NH
ZT
iv
lU
BQ
ZG
hy
"}
(5,1,1) = {"
hy
Bz
Yi
al
WY
qM
EB
zX
hy
"}
(6,1,1) = {"
vv
IF
Ay
HX
Qe
dk
LE
cy
hy
"}
(7,1,1) = {"
cx
oZ
hT
Pe
Qe
DO
DH
dc
hy
"}
(8,1,1) = {"
mM
mM
Yv
fj
Cy
KV
zU
mL
mL
"}
(9,1,1) = {"
UC
mM
qc
YZ
nI
SV
nW
mL
UC
"}
(10,1,1) = {"
UC
mM
Zo
ps
AC
vh
PW
mL
UC
"}
(11,1,1) = {"
UC
uV
uV
xI
oS
fP
uV
uV
UC
"}
(12,1,1) = {"
UC
UC
uV
Bk
wL
Ky
uV
UC
UC
"}
(13,1,1) = {"
UC
UC
uV
Aj
Aj
Aj
uV
UC
UC
"}
