//MAP CONVERTED BY dmm2tgm.py THIS HEADER COMMENT PREVENTS RECONVERSION, DO NOT REMOVE
"aS" = (
/obj/machinery/door/airlock/public/glass{
	req_access_txt = "35"
	},
/obj/machinery/atmospherics/pipe/simple/supply/hidden/layer2{
	dir = 1
	},
/obj/machinery/atmospherics/pipe/simple/scrubbers/hidden/layer4{
	dir = 1
	},
/obj/machinery/door/firedoor/border_only,
/obj/machinery/door/firedoor/border_only{
	dir = 1
	},
/turf/open/floor/plasteel/dark,
/area/ship/crew/hydroponics)
"aW" = (
/obj/structure/cable{
	icon_state = "2-8"
	},
/obj/machinery/atmospherics/components/binary/pump/layer2,
/obj/machinery/light/directional/east,
/obj/structure/cable{
	icon_state = "1-2"
	},
/turf/open/floor/plating,
/area/ship/engineering)
"bQ" = (
/obj/machinery/chem_dispenser/mutagensaltpeter,
/obj/machinery/light/directional/east,
/turf/open/floor/plasteel/dark,
/area/ship/crew/hydroponics)
"cA" = (
/obj/structure/toilet{
	pixel_y = 10
	},
/obj/machinery/light/directional/north,
/turf/open/floor/hangar/plasteel/white,
/area/ship/crew/hydroponics)
"da" = (
/obj/effect/turf_decal/industrial/warning,
/turf/open/floor/plating,
/area/ship/external)
"dj" = (
/obj/structure/table/wood,
/obj/machinery/smartfridge/disks,
/obj/machinery/atmospherics/components/unary/vent_pump/on/layer2,
/turf/open/floor/plasteel/dark,
/area/ship/crew/hydroponics)
"dr" = (
/obj/machinery/atmospherics/pipe/simple/supply/hidden/layer2,
/obj/structure/chair/comfy/beige/directional/east,
/turf/open/floor/plasteel/dark,
/area/ship/bridge)
"dX" = (
/obj/structure/window/reinforced,
/obj/structure/flora/ausbushes/ywflowers,
/turf/open/floor/grass,
/area/ship/crew/hydroponics)
"fh" = (
/obj/machinery/power/terminal{
	dir = 8
	},
/obj/structure/cable{
	icon_state = "0-4"
	},
/obj/machinery/atmospherics/components/unary/vent_pump/on/layer2{
	dir = 4
	},
/turf/open/floor/plating,
/area/ship/engineering)
"fv" = (
/obj/effect/spawner/structure/window/reinforced,
/obj/machinery/door/poddoor/shutters{
	id = "flowerwindows";
	dir = 8
	},
/turf/open/floor/plating,
/area/ship/bridge)
"hn" = (
/obj/machinery/autolathe,
/obj/item/stack/sheet/glass{
	amount = 30
	},
/obj/item/stack/sheet/metal{
	amount = 30
	},
/obj/machinery/button/shieldwallgen{
	id = "flower_cargofield";
	pixel_x = 6;
	pixel_y = 27
	},
/obj/machinery/button/door{
	id = "flowerdoors";
	name = "Blast Door Control";
	pixel_x = -4;
	pixel_y = 28
	},
/obj/effect/turf_decal/industrial/warning/corner{
	dir = 1
	},
/obj/machinery/light/directional/east,
/turf/open/floor/plasteel/dark,
/area/ship/cargo)
"ho" = (
/obj/structure/cable{
	icon_state = "1-2"
	},
/obj/machinery/atmospherics/pipe/simple/supply/hidden/layer2{
	dir = 1
	},
/obj/structure/cable{
	icon_state = "0-2"
	},
/obj/machinery/power/apc/auto_name/directional/west,
/obj/machinery/atmospherics/pipe/simple/scrubbers/hidden/layer4{
	dir = 1
	},
/obj/machinery/light_switch{
	pixel_y = -12;
	pixel_x = -19;
	dir = 4
	},
/obj/machinery/firealarm/directional/west{
	pixel_y = 0;
	pixel_x = -41
	},
/turf/open/floor/plasteel/dark,
/area/ship/crew/hydroponics)
"hK" = (
/obj/machinery/power/smes/engineering,
/obj/structure/cable{
	icon_state = "0-2"
	},
/turf/open/floor/plating,
/area/ship/engineering)
"iq" = (
/obj/machinery/seed_extractor,
/turf/open/floor/plasteel/dark,
/area/ship/crew/hydroponics)
"iN" = (
/obj/structure/tank_dispenser/oxygen,
/obj/machinery/firealarm/directional/east,
/turf/open/floor/plasteel/dark,
/area/ship/cargo)
"jG" = (
/turf/closed/wall/r_wall,
/area/ship/engineering)
"kI" = (
/turf/open/floor/grass,
/area/ship/crew/hydroponics)
"lz" = (
/obj/structure/cable{
	icon_state = "1-2"
	},
/obj/machinery/button/door{
	dir = 8;
	id = "flowerengines";
	name = "Bridge Lockdown";
	pixel_x = 21;
	pixel_y = 0
	},
/obj/machinery/atmospherics/pipe/simple/supply/visible/layer2{
	dir = 1
	},
/turf/open/floor/plating,
/area/ship/engineering)
"mc" = (
/obj/machinery/atmospherics/components/unary/vent_pump/on/layer2{
	dir = 8
	},
/obj/machinery/firealarm/directional/east,
/turf/open/floor/plasteel/dark,
/area/ship/cargo)
"nh" = (
/obj/machinery/door/airlock/public/glass{
	req_access_txt = "35";
	dir = 8
	},
/obj/structure/cable{
	icon_state = "4-8"
	},
/obj/machinery/atmospherics/pipe/simple/supply/hidden/layer2{
	dir = 4
	},
/obj/machinery/atmospherics/pipe/simple/scrubbers/hidden/layer4{
	dir = 8
	},
/obj/machinery/door/firedoor/border_only{
	dir = 8
	},
/obj/machinery/door/firedoor/border_only{
	dir = 4
	},
/turf/open/floor/plasteel/dark,
/area/ship/crew/hydroponics)
"nu" = (
/obj/structure/reagent_dispensers/watertank/high,
/turf/open/floor/plating,
/area/ship/engineering)
"oa" = (
/turf/open/floor/plasteel/dark,
/area/ship/crew/hydroponics)
"oA" = (
/obj/machinery/hydroponics/constructable,
/turf/open/floor/plasteel/dark,
/area/ship/crew/hydroponics)
"oV" = (
/obj/machinery/door/poddoor{
	id = "flowerdoors";
	name = "Cargo Bay Blast Door";
	dir = 1
	},
/obj/machinery/door/firedoor/border_only,
/obj/machinery/door/firedoor/border_only{
	dir = 1
	},
/turf/open/floor/plasteel/tech,
/area/ship/cargo)
"qS" = (
/obj/machinery/door/airlock/public/glass{
	req_access_txt = "35";
	dir = 1
	},
/obj/machinery/door/firedoor/border_only,
/obj/machinery/door/firedoor/border_only{
	dir = 1
	},
/turf/open/floor/plasteel/dark,
/area/ship/crew/hydroponics)
"rb" = (
/obj/machinery/computer/cargo{
	dir = 8
	},
/turf/open/floor/plasteel/dark,
/area/ship/bridge)
"rE" = (
/obj/structure/window/reinforced{
	dir = 1
	},
/obj/structure/flora/ausbushes/leafybush{
	pixel_y = -6;
	pixel_x = -7
	},
/turf/open/floor/grass,
/area/ship/crew/hydroponics)
"sq" = (
/obj/machinery/door/airlock/freezer{
	dir = 8;
	req_access_txt = "35"
	},
/turf/open/floor/hangar/plasteel/white,
/area/ship/crew/hydroponics)
"ss" = (
/obj/structure/cable{
	icon_state = "1-4"
	},
/obj/structure/cable{
	icon_state = "1-2"
	},
/obj/machinery/atmospherics/pipe/simple/supply/visible/layer2{
	dir = 5
	},
/obj/machinery/atmospherics/pipe/manifold/scrubbers/hidden/layer4{
	dir = 1
	},
/turf/open/floor/plating,
/area/ship/engineering)
"sQ" = (
/obj/machinery/power/smes/shuttle/precharged{
	dir = 4
	},
/obj/structure/window/reinforced/spawner{
	dir = 8
	},
/obj/structure/cable{
	icon_state = "0-8"
	},
/turf/open/floor/plating,
/area/ship/engineering)
"th" = (
/obj/machinery/computer/helm{
	dir = 8
	},
/turf/open/floor/plasteel/dark,
/area/ship/bridge)
"ue" = (
/obj/machinery/cryopod{
	dir = 1
	},
/obj/machinery/computer/cryopod/directional/west{
	dir = 2;
	pixel_x = 0;
	pixel_y = -17
	},
/obj/machinery/light_switch{
	pixel_y = 0;
	pixel_x = -24;
	dir = 4
	},
/turf/open/floor/plasteel/dark,
/area/ship/bridge)
"uU" = (
/turf/closed/wall/r_wall,
/area/ship/bridge)
"vj" = (
/obj/structure/cable{
	icon_state = "4-8"
	},
/obj/structure/cable{
	icon_state = "1-8"
	},
/obj/machinery/atmospherics/pipe/manifold4w/supply/hidden/layer2,
/obj/machinery/atmospherics/pipe/manifold4w/scrubbers/hidden/layer4,
/turf/open/floor/plasteel/dark,
/area/ship/hallway/central)
"vQ" = (
/obj/structure/cable{
	icon_state = "1-4"
	},
/obj/effect/turf_decal/industrial/warning{
	dir = 1
	},
/turf/open/floor/plasteel/dark,
/area/ship/cargo)
"wd" = (
/obj/docking_port/mobile{
	launch_status = 0;
	port_direction = 2
	},
/obj/effect/turf_decal/industrial/warning,
/turf/open/floor/plating,
/area/ship/external)
"ws" = (
/turf/open/floor/plating,
/area/ship/engineering)
"xc" = (
/obj/structure/cable{
	icon_state = "0-8"
	},
/obj/structure/table/wood,
/obj/item/radio/intercom/wideband/directional/north,
/obj/machinery/atmospherics/components/unary/vent_scrubber/on/layer4{
	dir = 8
	},
/obj/machinery/power/apc/auto_name/directional/east,
/obj/machinery/button/door{
	dir = 8;
	id = "flowerwindows";
	name = "Bridge Lockdown";
	pixel_x = 1;
	pixel_y = 3
	},
/turf/open/floor/plasteel/dark,
/area/ship/bridge)
"yq" = (
/obj/machinery/atmospherics/components/unary/vent_scrubber/on/layer4{
	dir = 8
	},
/obj/machinery/atmospherics/pipe/simple/supply/hidden/layer2{
	dir = 4
	},
/obj/machinery/light/directional/north,
/turf/open/floor/plasteel/dark,
/area/ship/crew/hydroponics)
"yA" = (
/obj/machinery/power/port_gen/pacman,
/obj/structure/cable{
	icon_state = "0-4"
	},
/obj/item/stack/sheet/mineral/plasma{
	amount = 25
	},
/turf/open/floor/plating,
/area/ship/engineering)
"yG" = (
/obj/structure/cable,
/obj/machinery/power/ship_gravity,
/turf/open/floor/plating,
/area/ship/engineering)
"zn" = (
/obj/structure/cable{
	icon_state = "4-8"
	},
/obj/machinery/atmospherics/components/unary/vent_scrubber/on/layer4{
	dir = 4
	},
/turf/open/floor/plasteel/dark,
/area/ship/cargo)
"AB" = (
/obj/structure/cable{
	icon_state = "1-2"
	},
/obj/structure/cable{
	icon_state = "1-8"
	},
/obj/machinery/light/directional/east,
/turf/open/floor/plating,
/area/ship/engineering)
"AF" = (
/obj/machinery/atmospherics/pipe/simple/scrubbers/hidden/layer4{
	dir = 8
	},
/obj/machinery/atmospherics/pipe/simple/supply/hidden/layer2{
	dir = 4
	},
/turf/open/floor/plasteel/dark,
/area/ship/crew/hydroponics)
"AP" = (
/obj/structure/cable{
	icon_state = "4-8"
	},
/obj/machinery/atmospherics/pipe/simple/supply/visible/layer2{
	dir = 8
	},
/obj/machinery/door/airlock/engineering/glass{
	req_access_txt = "35";
	dir = 8
	},
/obj/machinery/atmospherics/pipe/simple/scrubbers/visible/layer4{
	dir = 4
	},
/obj/machinery/door/firedoor/border_only{
	dir = 8
	},
/obj/machinery/door/firedoor/border_only{
	dir = 4
	},
/turf/open/floor/plating,
/area/ship/engineering)
"AX" = (
/obj/machinery/power/terminal{
	dir = 8
	},
/obj/structure/cable{
	icon_state = "0-4"
	},
/obj/structure/cable,
/turf/open/floor/plating,
/area/ship/engineering)
"Cf" = (
/obj/machinery/holopad/emergency/command,
/turf/open/floor/plasteel/dark,
/area/ship/crew/hydroponics)
"CA" = (
/obj/machinery/plantgenes{
	pixel_y = 7
	},
/obj/structure/table/wood,
/obj/machinery/atmospherics/components/unary/vent_scrubber/on/layer4,
/obj/machinery/light/directional/north,
/turf/open/floor/plasteel/dark,
/area/ship/crew/hydroponics)
"CK" = (
/obj/structure/cable{
	icon_state = "1-8"
	},
/obj/structure/cable{
	icon_state = "1-2"
	},
/obj/machinery/light_switch{
	pixel_y = 0;
	pixel_x = 23;
	dir = 8
	},
/turf/open/floor/plating,
/area/ship/engineering)
"CM" = (
/obj/effect/spawner/structure/window/reinforced,
/obj/machinery/door/poddoor/shutters{
	id = "flowerwindows";
	dir = 8
	},
/obj/machinery/door/poddoor/shutters{
	id = "flowerwindows";
	dir = 8
	},
/turf/open/floor/plating,
/area/ship/bridge)
"CP" = (
/obj/machinery/atmospherics/pipe/simple/supply/hidden/layer2{
	dir = 5
	},
/turf/open/floor/plasteel/dark,
/area/ship/bridge)
"DL" = (
/obj/machinery/atmospherics/pipe/simple/supply/hidden/layer2{
	dir = 5
	},
/obj/machinery/atmospherics/pipe/simple/scrubbers/hidden/layer4{
	dir = 5;
	pixel_y = 0
	},
/obj/machinery/airalarm/directional/west,
/turf/open/floor/plasteel/dark,
/area/ship/crew/hydroponics)
"EV" = (
/obj/structure/cable{
	icon_state = "4-8"
	},
/obj/machinery/atmospherics/pipe/simple/scrubbers/hidden/layer4{
	dir = 8
	},
/obj/machinery/atmospherics/pipe/simple/supply/hidden/layer2{
	dir = 4
	},
/turf/open/floor/plasteel/dark,
/area/ship/hallway/central)
"Fd" = (
/obj/structure/table/wood,
/obj/machinery/atmospherics/components/unary/vent_pump/on/layer2{
	dir = 8
	},
/obj/machinery/microwave{
	pixel_y = 5;
	pixel_x = -1
	},
/turf/open/floor/plasteel/dark,
/area/ship/bridge)
"Fi" = (
/obj/effect/turf_decal/industrial/warning/corner,
/turf/open/floor/plating,
/area/ship/external)
"Fp" = (
/obj/structure/cable{
	icon_state = "0-2"
	},
/obj/machinery/power/shieldwallgen/atmos/roundstart{
	dir = 8;
	id = "flower_cargofield";
	locked = 1
	},
/obj/machinery/door/poddoor{
	id = "flowerdoors";
	name = "Cargo Bay Blast Door";
	dir = 1
	},
/obj/machinery/door/firedoor/border_only,
/obj/machinery/door/firedoor/border_only{
	dir = 1
	},
/turf/open/floor/plasteel/tech,
/area/ship/cargo)
"FE" = (
/obj/machinery/atmospherics/components/unary/outlet_injector/on/layer4{
	dir = 4
	},
/turf/open/floor/plating,
/area/ship/external)
"FK" = (
/obj/structure/cable{
	icon_state = "2-8"
	},
/obj/machinery/atmospherics/pipe/simple/supply/hidden/layer2{
	dir = 6
	},
/obj/machinery/atmospherics/pipe/simple/scrubbers/hidden/layer4{
	dir = 10
	},
/obj/structure/cable{
	icon_state = "1-2"
	},
/turf/open/floor/plasteel/dark,
/area/ship/cargo)
"FQ" = (
/obj/structure/flora/ausbushes/sunnybush{
	pixel_y = -3;
	pixel_x = -14
	},
/obj/structure/flora/tree/chapel{
	pixel_x = -24;
	pixel_y = -26;
	density = 0
	},
/turf/open/floor/grass,
/area/ship/crew/hydroponics)
"FZ" = (
/obj/structure/window/reinforced{
	dir = 8
	},
/obj/structure/window/reinforced{
	dir = 1
	},
/obj/structure/flora/ausbushes/ywflowers,
/turf/open/floor/grass,
/area/ship/crew/hydroponics)
"Hd" = (
/obj/structure/window/fulltile,
/obj/structure/grille,
/turf/open/floor/plating,
/area/ship/crew/hydroponics)
"HI" = (
/obj/machinery/airalarm/directional/west,
/obj/structure/cable{
	icon_state = "1-4"
	},
/obj/item/kirbyplants/random,
/turf/open/floor/plasteel/dark,
/area/ship/cargo)
"Ih" = (
/obj/structure/bed,
/obj/structure/curtain/bounty,
/obj/item/bedsheet/random,
/obj/machinery/light/directional/north,
/obj/machinery/firealarm/directional/east,
/turf/open/floor/plasteel/dark,
/area/ship/bridge)
"IL" = (
/obj/item/clothing/suit/hazardvest{
	desc = "A high-visibility lifejacket complete with whistle and slot for oxygen tanks.";
	name = "emergency lifejacket"
	},
/obj/item/clothing/head/hardhat/mining,
/obj/item/gps/mining,
/obj/item/gps/mining,
/obj/item/clothing/glasses/meson/prescription,
/obj/item/clothing/glasses/meson,
/obj/item/t_scanner/adv_mining_scanner/lesser,
/obj/item/gun/energy/kinetic_accelerator,
/obj/item/storage/bag/ore,
/obj/structure/closet/wall/directional/north{
	name = "equipment closet"
	},
/obj/machinery/power/apc/auto_name/directional/west,
/obj/structure/cable{
	icon_state = "0-2"
	},
/obj/effect/turf_decal/industrial/warning/corner{
	dir = 4
	},
/obj/machinery/light_switch{
	pixel_y = -14;
	pixel_x = -19;
	dir = 4
	},
/turf/open/floor/plasteel/dark,
/area/ship/cargo)
"Jb" = (
/obj/machinery/door/airlock/command/glass{
	dir = 4;
	req_access_txt = "35"
	},
/obj/structure/cable{
	icon_state = "4-8"
	},
/obj/machinery/atmospherics/pipe/simple/scrubbers/hidden/layer4{
	dir = 8
	},
/obj/machinery/atmospherics/pipe/simple/supply/hidden/layer2{
	dir = 4
	},
/obj/machinery/door/firedoor/border_only{
	dir = 4
	},
/obj/machinery/door/firedoor/border_only{
	dir = 8
	},
/turf/open/floor/plasteel/dark,
/area/ship/bridge)
"JD" = (
/obj/structure/cable{
	icon_state = "1-2"
	},
/obj/machinery/door/airlock/mining/glass{
	req_access_txt = "35"
	},
/obj/machinery/atmospherics/pipe/simple/supply/hidden/layer2{
	dir = 1
	},
/obj/machinery/atmospherics/pipe/simple/scrubbers/hidden/layer4{
	dir = 1
	},
/obj/machinery/door/firedoor/border_only,
/obj/machinery/door/firedoor/border_only{
	dir = 1
	},
/turf/open/floor/plasteel/dark,
/area/ship/cargo)
"Ku" = (
/obj/structure/cable{
	icon_state = "4-8"
	},
/obj/machinery/atmospherics/pipe/simple/scrubbers/hidden/layer4{
	dir = 8
	},
/obj/machinery/atmospherics/pipe/simple/supply/hidden/layer2{
	dir = 4
	},
/obj/machinery/light/directional/south,
/turf/open/floor/plasteel/dark,
/area/ship/hallway/central)
"KD" = (
/obj/machinery/door/airlock/command/glass{
	dir = 4;
	req_access_txt = "35"
	},
/obj/machinery/door/firedoor/border_only{
	dir = 4
	},
/obj/machinery/door/firedoor/border_only{
	dir = 8
	},
/turf/open/floor/plasteel/dark,
/area/ship/bridge)
"KN" = (
/obj/structure/cable{
	icon_state = "1-8"
	},
/obj/machinery/atmospherics/pipe/simple/scrubbers/hidden/layer4{
	dir = 9
	},
/obj/machinery/atmospherics/pipe/simple/supply/hidden/layer2{
	dir = 9
	},
/turf/open/floor/plasteel/dark,
/area/ship/crew/hydroponics)
"KR" = (
/obj/machinery/power/terminal{
	dir = 8
	},
/obj/structure/cable{
	icon_state = "0-4"
	},
/obj/structure/cable{
	icon_state = "0-4"
	},
/turf/open/floor/plating,
/area/ship/engineering)
"Lc" = (
/obj/effect/turf_decal/industrial/warning/corner{
	dir = 8
	},
/turf/open/floor/plating,
/area/ship/external)
"Lm" = (
/obj/structure/sink{
	dir = 4;
	pixel_x = -13;
	pixel_y = 4
	},
/turf/open/floor/hangar/plasteel/white,
/area/ship/crew/hydroponics)
"Ma" = (
/obj/machinery/atmospherics/components/unary/vent_pump/on/layer2{
	dir = 8
	},
/turf/open/floor/plasteel/dark,
/area/ship/crew/hydroponics)
"Mu" = (
/obj/machinery/biogenerator,
/obj/machinery/light/directional/north,
/turf/open/floor/plasteel/dark,
/area/ship/crew/hydroponics)
"MF" = (
/obj/machinery/atmospherics/pipe/simple/scrubbers/visible/layer4{
	dir = 4
	},
/obj/structure/window/reinforced/spawner{
	dir = 8
	},
/obj/machinery/door/poddoor{
	dir = 4;
	id = "flowerengines"
	},
/turf/open/floor/plating,
/area/ship/engineering)
"Nm" = (
/turf/closed/wall/r_wall,
/area/ship/cargo)
"Nr" = (
/obj/structure/window/reinforced{
	dir = 8
	},
/obj/structure/window/reinforced,
/obj/structure/flora/ausbushes/leafybush,
/turf/open/floor/grass,
/area/ship/crew/hydroponics)
"Nv" = (
/obj/structure/cable{
	icon_state = "0-2"
	},
/obj/machinery/power/shieldwallgen/atmos/roundstart{
	dir = 4;
	id = "flower_cargofield";
	locked = 1
	},
/obj/machinery/door/poddoor{
	id = "flowerdoors";
	name = "Cargo Bay Blast Door";
	dir = 1
	},
/obj/machinery/door/firedoor/border_only,
/obj/machinery/door/firedoor/border_only{
	dir = 1
	},
/turf/open/floor/plasteel/tech,
/area/ship/cargo)
"NU" = (
/obj/structure/cable{
	icon_state = "1-8"
	},
/obj/effect/turf_decal/industrial/warning{
	dir = 1
	},
/turf/open/floor/plasteel/dark,
/area/ship/cargo)
"Op" = (
/turf/open/floor/plasteel/dark,
/area/ship/bridge)
"OF" = (
/obj/structure/table/wood,
/obj/item/storage/box/donkpockets/donkpocketberry{
	pixel_y = 4
	},
/obj/item/storage/box/donkpockets{
	pixel_x = -2;
	pixel_y = 7
	},
/obj/machinery/airalarm/directional/east,
/obj/machinery/light/directional/south,
/turf/open/floor/plasteel/dark,
/area/ship/bridge)
"ON" = (
/obj/structure/rack,
/obj/item/storage/toolbox/mechanical{
	pixel_y = -1
	},
/obj/item/storage/toolbox/electrical{
	pixel_y = 5
	},
/obj/item/storage/box/disks_plantgene,
/obj/item/storage/box/disks_plantgene,
/obj/item/storage/box/disks_plantgene,
/obj/machinery/atmospherics/pipe/simple/scrubbers/visible/layer4{
	dir = 4
	},
/turf/open/floor/plating,
/area/ship/engineering)
"OV" = (
/obj/structure/cable{
	icon_state = "2-4"
	},
/obj/machinery/atmospherics/pipe/simple/supply/hidden/layer2{
	dir = 6
	},
/obj/machinery/airalarm/directional/west,
/obj/machinery/atmospherics/pipe/manifold/scrubbers/hidden/layer4{
	dir = 8
	},
/turf/open/floor/plasteel/dark,
/area/ship/crew/hydroponics)
"Pu" = (
/obj/effect/spawner/structure/window/reinforced,
/obj/machinery/door/poddoor/shutters{
	id = "flowerwindows"
	},
/turf/open/floor/plating,
/area/ship/crew/hydroponics)
"PE" = (
/obj/machinery/power/terminal{
	dir = 8
	},
/obj/structure/cable{
	icon_state = "0-4"
	},
/obj/machinery/atmospherics/components/unary/vent_scrubber/on/layer4{
	dir = 4
	},
/turf/open/floor/plating,
/area/ship/engineering)
"PH" = (
/obj/structure/cable{
	icon_state = "1-2"
	},
/obj/structure/cable{
	icon_state = "2-8"
	},
/obj/machinery/airalarm/directional/east,
/obj/machinery/atmospherics/pipe/manifold/supply/visible/layer2{
	dir = 4
	},
/turf/open/floor/plating,
/area/ship/engineering)
"Qg" = (
/obj/effect/spawner/structure/window/reinforced,
/turf/open/floor/plating,
/area/ship/cargo)
"Qv" = (
/obj/structure/cable{
	icon_state = "1-2"
	},
/obj/structure/cable{
	icon_state = "1-8"
	},
/obj/structure/cable{
	icon_state = "0-8"
	},
/obj/machinery/power/apc/auto_name/directional/east,
/obj/machinery/atmospherics/pipe/simple/scrubbers/visible/layer4{
	dir = 9
	},
/turf/open/floor/plating,
/area/ship/engineering)
"Qy" = (
/obj/machinery/power/terminal{
	dir = 8
	},
/obj/structure/cable{
	icon_state = "0-2"
	},
/obj/machinery/atmospherics/components/unary/portables_connector/visible/layer2,
/obj/machinery/firealarm/directional/east,
/turf/open/floor/plating,
/area/ship/engineering)
"QD" = (
/obj/machinery/atmospherics/pipe/simple/supply/hidden/layer2,
/turf/open/floor/plasteel/dark,
/area/ship/bridge)
"Rk" = (
/turf/template_noop,
/area/space)
"Rw" = (
/obj/structure/cable{
	icon_state = "4-8"
	},
/obj/machinery/atmospherics/pipe/simple/scrubbers/hidden/layer4{
	dir = 8
	},
/obj/machinery/atmospherics/pipe/simple/supply/hidden/layer2{
	dir = 4
	},
/turf/open/floor/plasteel/dark,
/area/ship/crew/hydroponics)
"RC" = (
/turf/closed/wall/r_wall,
/area/ship/crew/hydroponics)
"RK" = (
/obj/structure/cable{
	icon_state = "4-8"
	},
/obj/machinery/atmospherics/pipe/simple/scrubbers/hidden/layer4{
	dir = 8
	},
/obj/machinery/atmospherics/pipe/simple/supply/hidden/layer2{
	dir = 10
	},
/turf/open/floor/plasteel/dark,
/area/ship/bridge)
"So" = (
/obj/machinery/power/shuttle/engine/electric{
	dir = 4
	},
/obj/structure/cable{
	icon_state = "0-4"
	},
/obj/machinery/door/poddoor{
	dir = 4;
	id = "flowerengines"
	},
/turf/open/floor/plating,
/area/ship/engineering)
"Sy" = (
/obj/machinery/hydroponics/constructable,
/obj/machinery/light/directional/south,
/turf/open/floor/plasteel/dark,
/area/ship/crew/hydroponics)
"Ta" = (
/obj/machinery/vending/hydroseeds{
	all_items_free = 1
	},
/turf/open/floor/plasteel/dark,
/area/ship/crew/hydroponics)
"Td" = (
/obj/structure/cable{
	icon_state = "0-8"
	},
/obj/structure/cable{
	icon_state = "4-8"
	},
/obj/machinery/atmospherics/pipe/simple/scrubbers/hidden/layer4{
	dir = 8
	},
/obj/machinery/atmospherics/pipe/manifold/supply/hidden/layer2,
/turf/open/floor/plasteel/dark,
/area/ship/crew/hydroponics)
"Vi" = (
/obj/structure/cable{
	icon_state = "2-4"
	},
/obj/structure/cable{
	icon_state = "2-8"
	},
/obj/effect/turf_decal/industrial/warning{
	dir = 1
	},
/turf/open/floor/plasteel/dark,
/area/ship/cargo)
"Wo" = (
/obj/effect/spawner/structure/window/reinforced,
/turf/open/floor/plating,
/area/ship/crew/hydroponics)
"Ze" = (
/obj/machinery/door/poddoor/shutters{
	id = "flowerwindows"
	},
/obj/effect/spawner/structure/window/reinforced,
/turf/open/floor/plating,
/area/ship/crew/hydroponics)
"ZX" = (
/obj/machinery/hydroponics/constructable,
/obj/machinery/firealarm/directional/south,
/turf/open/floor/plasteel/dark,
/area/ship/crew/hydroponics)

(1,1,1) = {"
Rk
jG
So
jG
So
FE
So
jG
So
jG
Rk
"}
(2,1,1) = {"
jG
jG
sQ
jG
sQ
MF
sQ
jG
sQ
jG
jG
"}
(3,1,1) = {"
jG
hK
AX
nu
fh
ON
PE
yA
KR
ws
jG
"}
(4,1,1) = {"
jG
Qy
aW
lz
PH
ss
Qv
AB
CK
yG
jG
"}
(5,1,1) = {"
jG
jG
jG
jG
jG
AP
jG
jG
jG
jG
jG
"}
(6,1,1) = {"
Fi
Nm
IL
HI
Qg
EV
RC
cA
Lm
RC
Rk
"}
(7,1,1) = {"
da
Nv
vQ
zn
Qg
Ku
RC
RC
sq
RC
Rk
"}
(8,1,1) = {"
wd
oV
Vi
FK
JD
vj
aS
DL
oa
Ze
Rk
"}
(9,1,1) = {"
da
Fp
NU
mc
Qg
EV
Wo
AF
oA
Ze
Rk
"}
(10,1,1) = {"
Lc
Nm
hn
iN
Qg
EV
Wo
AF
ZX
RC
Rk
"}
(11,1,1) = {"
Rk
RC
RC
RC
RC
nh
RC
yq
Sy
RC
Rk
"}
(12,1,1) = {"
Rk
RC
CA
OV
ho
KN
Wo
Ma
Ta
Pu
Rk
"}
(13,1,1) = {"
Rk
Pu
dj
Td
Cf
oa
qS
oa
oA
Pu
Rk
"}
(14,1,1) = {"
Rk
Pu
iq
Rw
FZ
kI
Nr
oa
oA
Pu
Rk
"}
(15,1,1) = {"
Rk
RC
Mu
Rw
rE
FQ
dX
oa
bQ
RC
Rk
"}
(16,1,1) = {"
Rk
uU
uU
Jb
Hd
Hd
Hd
KD
uU
uU
Rk
"}
(17,1,1) = {"
Rk
uU
Ih
RK
QD
dr
CP
Op
ue
uU
Rk
"}
(18,1,1) = {"
Rk
uU
uU
xc
th
rb
Fd
OF
uU
uU
Rk
"}
(19,1,1) = {"
Rk
Rk
uU
uU
fv
fv
CM
uU
uU
Rk
Rk
"}
(20,1,1) = {"
Rk
Rk
Rk
Rk
Rk
Rk
Rk
Rk
Rk
Rk
Rk
"}
